NO ./textures/eagle.xpm
SO ./textures/redbrick.xpm
WE ./textures/purplestone.xpm
EA ./textures/greystone.xpm

F 0,255,255
C 255,255,0

        1111111111111111111111111
        1000000000110000000000001
        1011000001110000000000001
        10010000000000000000000W1
111111111011000001110000000000001
100000000011000001110111111111111
11110111111111011100000010001
11110111111111011101010010001
10000000110101011100000010001
10000000000000001100000010001    1
10000000000000001101010010001   101
110000011101010111110111100011   1
11110111 1110101 101111010001
11111111 1111111 111111111111